3 3 3 3 3 3 3 3
710 0 0 0 0 1 0 0
0 0 0 71 0 1 0 0
9 0 0 0 1 1 1 710
0 0 0 0 0 8 0 0
0 0 0 0 0 61 0 0
0 0 0 710 0 0 78 0
0 710 0 0 0 0 0 710