3 3 3 3 3 3 3 3
71 3 75 9 9 1 3 52
9 9 9 2 9 1 9 9
74 3 0 9 9 1 1 0
3 6 3 3 3 9 9 3
9 9 9 9 9 9 9 511
3 3 3 3 3 3 3 3
3 3 3 3 3 3 3 3